22 22 22 22 22 22 22 22 22 22 22 22 22 22 22 22 22 22 22 22 22 22 22 22 22 22 22 22 22 22 22 22 22 22 22 22 22 22 22 22
22 22 22 22 22 22 22 22 22 22 22 22 22 22 22 22 22 22 22 22 22 22 22 22 22 22 22 22 22 22 22 22 22 22 22 22 22 22 22 22
22 22 22 22 22 22 22 22 22 22 22 22 22 22 22 22 22 22 22 22 22 22 22 22 22 22 22 22 22 22 22 22 22 22 22 22 22 22 22 22
22 22 22 22 10 22 10 10 22 10 10 10 22 10 10 10 10 22 10 10 22 10 10 22 10 10 22 10 10 22 10 10 10 22 10 22 22 22 22 22
22 22 22 10 10 10 10 10 10 10 22 10 10 10 22 10 22 10 22 10 10 22 10 10 22 10 22 22 10 10 22 10 22 10 22 10 22 22 22 22
22 22 22 10 10 10 22 10 10 22 10 10 10 10 10 22 10 10 10 10 10 10 10 10 10 10 10 10 10 10 10 10 10 10 10 10 10 22 22 22
22 22 22 22 10 10 10 10 10 10 10 10 10 22 10 10 10 10 10 10 10 10 10 10 10 10 10 10 10 10 10 10 10 10 10 10 22 22 22 22
22 22 22 10 10 10 10 22 10 10 22 10 10 22 10 10 10 10 10 10 10 10 10 10 10 10 10 10 10 10 10 10 10 10 10 10 10 22 22 22
22 22 22 22 10 10 10 10 22 10 10 10 22 10 10 10 10 10 10 10 10 10 10 10 10 10 10 10 10 10 10 10 10 10 10 10 22 22 22 22
22 22 22 10 10 10 22 10 10 22 10 22 10 10 10 10 10 10 10 10 10 10 10 10 10 10 10 10 10 10 10 10 10 10 10 10 22 22 22 22
22 22 22 22 10 10 10 22 10 22 10 10 10 10 10 10 10 10 10 10 10 10 10 10 10 10 10 10 10 10 10 10 10 10 10 10 10 22 22 22
22 22 22 10 22 10 10 22 10 10 10 10 22 10 10 10 10 10 10 10 10 10 10 10 10 10 10 10 10 10 10 10 10 10 10 22 10 22 22 22
22 22 22 22 10 22 10 10 10 22 10 10 10 10 10 34 33 33 32 10 10 10 10 10 10 10 10 10 10 10 10 10 10 10 10 10 22 22 22 22
22 22 22 10 10 10 10 22 10 10 10 22 10 10 10 35 20 20 26 32 10 10 10 10 10 10 10 10 10 10 10 10 10 10 10 10 10 22 22 22
22 22 22 10 10 10 10 10 10 10 22 10 22 10 10 35 20 20 20 31 10 10 10 10 10 10 10 10 10 10 10 10 10 10 10 10 22 22 22 22
22 22 22 22 10 10 10 10 22 10 22 10 22 10 10 35 20 20 20 31 10 10 10 10 10 10 10 10 10 10 10 10 10 10 10 10 10 22 22 22
22 22 22 10 10 10 10 22 22 22 22 22 22 22 10 35 20 20 20 31 10 10 10 10 10 10 10 10 10 10 10 10 10 10 10 10 22 22 22 22
22 22 22 10 10 10 10 10 22 22 22 22 22 22 22 28 29 29 29 30 10 10 10 10 10 10 10 10 10 10 10 10 10 10 10 10 10 22 22 22
22 22 22 10 22 10 10 22 22 22 10 22 22 10 10 22 10 10 10 10 10 10 10 10 10 10 10 10 10 10 10 10 10 10 10 10 10 22 22 22
22 22 22 22 10 10 10 10 22 22 10 22 22 22 10 10 10 10 10 10 10 10 10 10 10 10 10 10 10 10 10 10 10 10 10 10 22 22 22 22
22 22 22 10 10 10 10 22 22 22 10 22 22 22 10 10 10 10 10 10 10 10 10 10 10 10 10 10 10 10 10 10 10 10 10 10 10 22 22 22
22 22 22 22 10 10 10 22 10 22 10 10 22 10 22 10 10 22 10 10 10 10 10 10 10 10 10 10 10 10 10 10 10 10 10 10 10 22 22 22
22 22 22 10 10 10 10 10 10 10 10 10 22 22 10 22 10 10 10 10 10 10 10 10 10 10 10 10 10 10 10 10 10 10 10 22 10 22 22 22
22 22 22 10 10 10 10 10 10 10 10 10 10 22 22 10 10 22 10 10 10 10 10 10 10 10 10 10 10 10 10 10 10 10 10 10 10 22 22 22
22 22 22 22 10 10 10 10 10 10 10 10 22 22 22 10 10 10 10 10 10 10 10 10 22 10 10 10 10 10 10 10 10 10 10 22 10 22 22 22
22 22 22 10 10 22 10 10 10 10 10 22 10 22 10 10 10 10 22 10 22 10 10 10 10 10 10 10 22 10 10 10 10 10 10 10 22 22 22 22
22 22 22 10 10 10 22 10 22 22 10 22 22 22 10 22 22 10 22 10 10 10 10 10 10 10 22 10 10 10 22 22 10 10 22 22 22 22 22 22
22 22 22 22 22 22 22 22 22 22 22 22 22 22 22 22 22 22 22 22 22 22 22 22 22 22 22 22 22 22 22 22 22 22 22 22 22 22 22 22
22 22 22 22 22 22 22 22 22 22 22 22 22 22 22 22 22 22 22 22 22 22 22 22 22 22 22 22 22 22 22 22 22 22 22 22 22 22 22 22
22 22 22 22 22 22 22 22 22 22 22 22 22 22 22 22 22 22 22 22 22 22 22 22 22 22 22 22 22 22 22 22 22 22 22 22 22 22 22 22