22 22 22 22 22 22 22 22 22 22 22 22 22 22 22 22 22 22 22 22 22 22 22 22 22 22 22 22 22 22 22 22 22 22 22 22 22 22 22 22
22 22 22 22 22 22 22 22 22 22 22 22 22 22 22 22 22 22 22 22 22 22 22 22 22 22 22 22 22 22 22 22 22 22 22 22 22 22 22 22
22 22 22 22 22 22 22 22 22 22 22 22 22 22 22 22 22 22 22 22 22 22 22 22 22 22 22 22 22 22 22 22 22 22 22 22 22 22 22 22
22 22 22 22 22 22 22 22 22 22 22 22 22 22 22 22 22 22 22 22 22 22 22 22 22 22 22 22 22 22 22 22 22 22 22 22 22 22 22 22
22 22 22 22 22 22 22 22 22 22 22 22 22 22 22 22 22 22 22 22 22 22 22 22 22 22 22 22 22 22 22 22 22 22 22 22 22 22 22 22
22 22 22 22 22 22 22 22 10 10 10 10 22 22 22 22 22 22 10 10 10 10 22 22 22 22 22 22 22 10 10 10 10 22 22 22 22 22 22 22
22 22 22 22 22 22 22 22 10 10 10 10 10 10 10 10 10 10 10 10 10 10 10 10 10 10 10 10 10 10 10 10 10 22 22 22 22 22 22 22
22 22 22 22 22 22 22 22 10 10 10 10 10 10 10 10 10 10 10 10 10 10 10 10 10 10 10 10 10 10 10 10 10 22 22 22 22 22 22 22
22 22 22 22 22 22 22 22 10 10 10 10 22 22 22 22 22 22 10 10 10 10 22 22 22 22 22 22 22 10 10 10 10 22 22 22 22 22 22 22
22 22 22 22 22 22 22 22 22 10 10 22 22 22 22 22 22 22 22 10 10 22 22 22 22 22 22 22 22 22 10 10 22 22 22 22 22 22 22 22
22 22 22 22 22 22 22 22 22 10 10 22 22 22 22 22 22 22 22 10 10 22 22 22 22 22 22 22 22 22 10 10 22 22 22 22 22 22 22 22
22 22 22 22 22 22 22 22 22 10 10 22 22 22 22 22 22 22 22 10 10 22 22 22 22 22 22 22 22 22 10 10 22 22 22 22 22 22 22 22
22 22 22 22 22 22 22 22 22 10 10 22 22 22 22 22 22 22 22 10 10 22 22 22 22 22 22 22 22 22 10 10 22 22 22 22 22 22 22 22
22 22 22 22 22 22 22 22 22 10 10 22 22 22 22 22 22 22 22 10 10 22 22 22 22 22 22 22 22 22 10 10 22 22 22 22 22 22 22 22
22 22 22 22 22 22 22 22 22 10 10 22 22 22 22 22 22 22 22 10 10 22 22 22 22 22 22 22 22 22 10 10 22 22 22 22 22 22 22 22
22 22 22 22 22 22 22 22 22 10 10 22 22 22 22 22 22 22 22 10 10 22 22 22 22 22 22 22 22 22 10 10 22 22 22 22 22 22 22 22
22 22 22 22 22 22 22 22 10 10 10 10 22 22 22 22 22 22 10 10 10 10 22 22 22 22 22 22 22 10 10 10 10 22 22 22 22 22 22 22
22 22 22 22 22 22 22 22 10 10 10 10 22 22 22 22 22 22 10 10 10 10 22 22 22 22 22 22 22 10 10 10 10 22 22 22 22 22 22 22
22 22 22 22 22 22 22 22 10 10 10 10 22 22 22 22 22 22 10 10 10 10 22 22 22 22 22 22 10 10 10 10 10 10 22 22 22 22 22 22
22 22 22 22 22 22 22 22 10 10 10 10 22 22 22 22 22 22 10 10 10 10 22 22 22 22 22 10 10 10 10 10 10 10 10 22 22 22 22 22
22 22 22 22 22 22 22 22 22 10 10 22 22 22 22 22 22 22 22 10 10 22 22 22 22 22 22 10 10 10 10 10 10 10 10 22 22 22 22 22
22 22 22 22 22 22 22 22 22 10 10 22 22 22 22 22 22 22 22 10 10 22 22 22 22 22 22 10 10 10 10 10 10 10 10 22 22 22 22 22
22 22 22 22 22 22 22 22 22 10 10 22 22 22 22 22 22 22 22 10 10 22 22 22 22 22 22 10 10 10 10 10 10 10 10 22 22 22 22 22
22 22 22 22 22 22 22 22 22 10 10 22 22 22 22 22 22 22 22 10 10 22 22 22 22 22 22 22 10 10 10 10 10 10 22 22 22 22 22 22
22 22 22 22 22 22 22 22 22 10 10 22 22 22 22 22 22 22 22 10 10 22 22 22 22 22 22 22 22 22 22 22 22 22 22 22 22 22 22 22
22 22 22 22 22 22 22 22 22 10 10 22 22 22 22 22 22 22 22 10 10 22 22 22 22 22 22 22 22 22 22 22 22 22 22 22 22 22 22 22
22 22 22 22 22 22 22 22 22 10 22 22 22 22 22 22 22 22 22 10 10 22 22 22 22 22 22 22 22 22 22 22 22 22 22 22 22 22 22 22
22 22 22 22 22 22 22 22 10 10 10 10 22 22 22 22 22 22 10 10 10 10 22 22 22 22 22 22 22 22 22 22 22 22 22 22 22 22 22 22
22 22 22 22 22 22 22 22 10 10 10 10 22 22 22 22 22 22 10 10 10 10 22 22 22 22 22 22 22 22 22 22 22 22 22 22 22 22 22 22
22 22 22 22 22 22 22 22 10 10 10 10 22 22 22 22 22 22 10 10 10 10 22 22 22 22 22 22 22 22 22 22 22 22 22 22 22 22 22 22
22 22 22 22 22 22 22 22 10 10 10 10 22 22 22 22 22 22 10 10 10 10 22 22 22 22 22 22 22 22 22 22 22 22 22 22 22 22 22 22
22 22 22 22 22 22 22 22 22 22 22 22 22 22 22 22 22 22 22 10 10 22 22 22 22 22 22 22 22 22 22 22 22 22 22 22 22 22 22 22
22 22 22 22 22 22 22 22 22 22 22 22 22 22 22 22 22 10 10 10 10 10 10 22 22 22 22 22 22 22 22 22 22 22 22 22 22 22 22 22
22 22 22 22 22 22 22 22 22 22 22 22 22 22 22 22 22 10 10 10 10 10 10 22 22 22 22 22 22 22 22 22 22 22 22 22 22 22 22 22
22 22 22 22 22 22 22 22 22 22 22 22 22 22 22 10 10 10 10 10 10 10 10 10 10 22 22 22 22 22 22 22 22 22 22 22 22 22 22 22
22 22 22 22 22 22 22 22 22 22 22 22 22 22 22 10 10 10 10 10 10 10 10 10 10 22 22 22 22 22 22 22 22 22 22 22 22 22 22 22
22 22 22 22 22 22 22 22 22 22 22 22 22 22 22 22 22 22 22 22 22 22 22 22 22 22 22 22 22 22 22 22 22 22 22 22 22 22 22 22
22 22 22 22 22 22 22 22 22 22 22 22 22 22 22 22 22 22 22 22 22 22 22 22 22 22 22 22 22 22 22 22 22 22 22 22 22 22 22 22
22 22 22 22 22 22 22 22 22 22 22 22 22 22 22 22 22 22 22 22 22 22 22 22 22 22 22 22 22 22 22 22 22 22 22 22 22 22 22 22
22 22 22 22 22 22 22 22 22 22 22 22 22 22 22 22 22 22 22 22 22 22 22 22 22 22 22 22 22 22 22 22 22 22 22 22 22 22 22 22