22 22 22 22 22 22 22 22 22 22 22 22 22 22 22 22 22 22 22 22 22 22 22 22 22 22 22 22 22 22 22 22 22 22 22 22 22 22 22 22
22 22 22 22 22 22 22 22 22 22 22 22 22 22 22 22 22 22 22 22 22 22 22 22 22 22 22 22 22 22 22 22 22 22 22 22 22 22 22 22
22 22 22 22 22 22 22 22 22 22 22 22 22 22 22 22 22 22 22 22 22 22 22 22 22 22 22 22 22 22 22 22 22 22 22 22 22 22 22 22
22 22 22 22 22 22 22 22 22 22 22 22 22 22 22 22 22 22 22 22 22 22 22 22 22 22 22 22 22 22 22 22 22 22 22 22 22 22 22 22
22 22 22 22 22 22 22 22 22 22 22 22 22 22 22 22 22 22 22 22 22 22 22 22 22 22 22 22 22 22 22 22 22 22 22 22 22 22 22 22
22 22 22 22 22 22 22 10 10 22 10 22 10 22 22 10 22 10 10 22 10 22 10 10 22 22 10 22 10 22 10 22 10 22 22 22 22 22 22 22
22 22 22 22 22 22 10 22 10 22 10 22 10 10 22 10 10 22 10 22 10 10 22 10 22 10 22 22 10 22 10 10 22 10 22 22 22 22 22 22
22 22 22 22 22 10 22 22 10 10 10 10 10 10 10 10 10 10 10 10 10 10 22 10 10 10 10 10 10 10 10 22 10 10 10 22 22 22 22 22
22 22 22 22 22 10 22 10 10 10 10 22 10 10 10 10 10 22 10 10 10 10 10 22 10 10 10 10 22 10 22 10 10 22 22 22 22 22 22 22
22 22 22 22 22 22 22 10 10 10 22 10 10 22 10 22 10 10 10 22 22 10 10 10 22 10 22 10 10 10 10 10 22 10 10 22 22 22 22 22
22 22 22 22 22 22 10 10 10 10 10 10 10 10 10 22 10 10 10 22 10 10 22 10 10 10 10 10 22 10 10 10 10 22 10 22 22 22 22 22
22 22 22 22 22 10 10 10 10 10 10 22 10 10 10 10 10 10 22 10 10 22 10 10 10 10 22 22 10 10 10 10 22 10 22 22 22 22 22 22
22 22 22 22 22 10 22 10 10 10 22 10 10 22 10 10 10 22 10 10 10 10 10 22 10 10 10 10 10 10 10 22 10 22 10 22 22 22 22 22
22 22 22 22 22 22 10 10 10 10 10 10 10 10 10 10 10 10 10 10 10 22 10 10 10 10 10 22 10 22 10 10 10 22 10 22 22 22 22 22
22 22 22 22 22 10 22 10 22 10 10 22 10 10 10 10 10 10 22 10 22 10 10 22 10 22 22 10 10 10 10 10 22 10 22 22 22 22 22 22
22 22 22 22 22 10 10 10 10 10 10 10 10 22 10 22 10 10 10 10 10 22 10 22 10 10 10 10 22 10 22 10 10 22 10 22 22 22 22 22
22 22 22 22 22 22 10 10 22 10 10 22 10 10 10 10 10 22 10 10 22 10 10 10 10 10 22 10 10 10 10 10 10 10 10 22 22 22 22 22
22 22 22 22 22 10 10 10 10 10 10 10 10 10 10 10 10 10 10 10 10 10 10 10 10 10 10 10 10 10 22 22 10 22 10 22 22 22 22 22
22 22 22 22 22 10 22 10 10 10 11 22 10 10 10 10 10 10 10 22 10 10 22 10 22 10 10 10 10 10 10 10 10 22 22 22 22 22 22 22
22 22 22 22 22 22 10 22 10 10 10 10 10 10 10 10 10 10 10 10 10 10 10 10 10 22 10 22 10 10 10 10 10 10 10 22 22 22 22 22
22 22 22 22 22 10 10 10 10 22 10 10 10 10 10 10 10 10 10 10 10 22 10 10 10 10 10 10 10 10 22 22 10 10 22 22 22 22 22 22
22 22 22 22 22 22 22 10 10 10 10 10 10 10 10 10 10 10 10 10 10 10 10 10 10 10 10 22 10 22 10 22 10 22 10 22 22 22 22 22
22 22 22 22 22 10 10 10 22 10 10 22 10 10 10 10 22 10 10 10 10 10 22 10 22 10 10 10 10 10 10 10 10 22 10 22 22 22 22 22
22 22 22 22 22 22 10 10 10 10 10 10 10 10 22 10 10 10 10 10 10 10 10 10 10 10 22 10 10 10 10 22 10 22 10 22 22 22 22 22
22 22 22 22 22 10 10 10 10 10 22 10 10 10 10 10 10 10 10 22 10 22 10 10 10 22 22 10 10 22 10 10 10 10 10 22 22 22 22 22
22 22 22 22 22 22 22 10 10 10 10 10 22 10 22 10 22 10 10 10 10 10 10 22 10 10 10 10 10 10 10 10 22 22 10 22 22 22 22 22
22 22 22 22 22 10 10 10 10 22 10 10 22 10 10 10 10 10 22 10 10 10 10 10 10 10 10 10 22 10 10 22 10 22 10 22 22 22 22 22
22 22 22 22 22 22 10 22 22 10 10 10 10 10 10 10 10 10 22 10 10 10 10 10 10 10 22 10 10 22 10 10 10 10 22 22 22 22 22 22
22 22 22 22 22 22 22 10 10 10 22 10 10 22 10 10 10 10 10 10 22 10 10 22 10 10 10 10 10 10 10 10 10 22 22 22 22 22 22 22
22 22 22 22 22 10 10 10 22 10 10 10 22 10 10 10 22 10 10 10 10 10 22 10 10 10 10 10 22 10 10 10 10 22 10 22 22 22 22 22
22 22 22 22 22 22 10 10 10 10 10 10 10 10 10 22 10 10 10 10 10 10 22 10 10 22 10 10 22 10 10 10 10 10 10 22 22 22 22 22
22 22 22 22 22 10 10 10 10 22 10 10 22 10 10 10 10 10 10 10 22 10 10 10 10 10 10 10 10 10 10 10 10 10 22 22 22 22 22 22
22 22 22 22 22 22 22 10 10 10 22 10 10 10 10 10 10 10 10 10 10 10 10 10 10 10 10 22 10 10 10 10 10 22 22 22 22 22 22 22
22 22 22 22 22 22 10 10 10 10 10 10 10 10 22 10 10 10 22 10 22 10 22 10 22 10 22 10 10 22 10 10 22 22 22 22 22 22 22 22
22 22 22 22 22 22 22 10 22 10 22 10 22 22 10 22 22 22 10 10 10 22 10 22 22 10 22 10 22 22 10 22 10 22 22 22 22 22 22 22
22 22 22 22 22 22 22 22 22 22 22 22 22 22 22 22 22 22 22 22 22 22 22 22 22 22 22 22 22 22 22 22 22 22 22 22 22 22 22 22
22 22 22 22 22 22 22 22 22 22 22 22 22 22 22 22 22 22 22 22 22 22 22 22 22 22 22 22 22 22 22 22 22 22 22 22 22 22 22 22
22 22 22 22 22 22 22 22 22 22 22 22 22 22 22 22 22 22 22 22 22 22 22 22 22 22 22 22 22 22 22 22 22 22 22 22 22 22 22 22
22 22 22 22 22 22 22 22 22 22 22 22 22 22 22 22 22 22 22 22 22 22 22 22 22 22 22 22 22 22 22 22 22 22 22 22 22 22 22 22
22 22 22 22 22 22 22 22 22 22 22 22 22 22 22 22 22 22 22 22 22 22 22 22 22 22 22 22 22 22 22 22 22 22 22 22 22 22 22 22