0 0 0 0 2 0 2 0 0 0 0 0 0 1 0 2
0 1 0 0 0 0 0 0 1 0 0 2 0 4 4 4
0 4 2 0 1 2 0 0 0 0 2 0 1 0 4 4
0 0 0 3 0 0 1 0 0 4 4 0 0 0 0 0
2 1 0 3 0 0 0 0 1 0 0 1 0 3 3 1
3 3 3 3 0 1 0 2 0 0 0 0 0 3 3 0
0 2 0 3 0 0 0 3 3 3 0 2 0 0 0 0
1 0 0 1 0 2 0 0 0 0 0 0 1 0 0 2
4 0 4 4 0 0 0 0 0 1 0 4 4 2 0 0
4 4 4 4 4 2 0 0 1 0 0 4 0 0 0 0
4 4 4 4 4 0 1 0 0 0 0 0 1 0 2 0
4 4 4 4 4 0 0 3 3 3 0 1 0 0 2 0