20 20 21 20 20 20 21 20 20 21 21 20 20 20 21 20 20 20 20 20 20 21 20 20 21 20 20 20 20 21 20 20 20 21 20 20 20 20 21 20
20 21 20 20 21 20 20 20 20 20 20 20 21 20 20 21 20 20 20 21 20 20 20 20 20 20 20 20 21 20 21 20 21 20 20 21 20 21 20 20
20 20 20 20 20 21 20 20 20 20 20 21 20 20 20 20 20 21 20 20 20 20 21 20 20 20 21 20 20 20 20 20 21 20 20 20 37 36 20 21
21 20 20 37 42 42 42 42 42 42 42 42 42 42 42 42 42 42 42 42 42 42 42 42 42 42 42 42 42 42 42 42 42 42 36 20 38 39 20 20
20 20 21 44 17 17 17 17 17 17 17 17 17 17 17 17 17 17 17 17 17 17 17 17 17 17 17 17 17 17 17 17 17 17 40 20 20 20 20 20
21 20 20 44 17 17 17 17 17 17 17 17 17 17 17 17 17 17 17 17 17 17 17 17 17 17 17 17 17 17 17 17 17 17 41 42 36 21 20 21
20 21 21 44 17 17 17 17 17 17 17 19 17 17 18 17 17 58 57 57 57 57 57 57 57 57 57 57 57 57 57 57 57 56 17 17 40 20 20 20
21 20 20 44 17 17 18 17 19 17 19 17 18 17 17 17 17 59 11 10 13 10 12 14 10 10 11 10 11 10 10 14 10 55 17 17 40 21 21 20
20 20 20 44 17 17 17 17 18 17 17 17 17 19 17 18 17 59 12 10 10 11 13 13 10 12 10 12 12 12 13 10 10 55 17 17 40 20 21 20
20 20 21 44 17 17 19 17 23 47 45 23 17 18 17 17 19 59 14 11 34 33 33 33 33 33 32 10 10 12 10 10 10 55 17 17 40 20 20 21
20 20 21 44 17 17 17 17 17 40 20 45 17 17 18 17 17 59 14 10 35 20 20 20 20 20 26 32 10 10 10 12 10 55 17 17 40 20 20 20
20 20 20 44 17 17 18 17 17 41 42 43 17 17 17 19 17 59 10 13 35 20 20 20 20 20 20 31 11 10 11 10 10 55 17 17 40 21 20 20
20 21 20 44 17 17 17 17 23 23 17 17 17 17 18 17 18 59 10 12 35 20 20 20 20 20 25 30 12 13 10 10 10 55 17 17 40 20 20 20
21 20 20 44 17 17 17 17 17 17 18 17 17 17 17 17 17 59 11 13 28 24 20 20 20 25 30 10 10 12 10 10 10 55 17 17 40 21 20 21
20 20 20 44 17 17 18 17 17 19 17 18 17 19 19 17 17 59 10 12 10 28 29 29 29 30 10 10 12 10 14 10 10 55 17 17 40 20 20 20
20 21 21 44 17 17 17 19 17 18 17 17 19 17 17 18 17 59 10 14 12 10 11 12 11 10 10 10 11 12 13 10 10 55 17 17 40 20 20 21
21 20 20 44 17 17 17 17 17 17 17 17 17 17 19 17 17 59 13 10 12 11 10 12 10 10 14 10 10 11 10 14 10 55 17 17 40 20 21 20
20 21 20 44 17 17 58 57 57 57 57 57 57 57 57 57 57 51 10 13 10 10 22 11 22 13 11 22 12 22 13 22 10 55 17 17 40 20 20 20
21 20 20 44 17 17 59 14 13 10 11 12 10 11 10 14 13 12 10 11 22 22 13 22 22 22 14 22 22 10 22 12 22 55 17 17 40 20 21 20
20 20 20 44 17 17 59 13 12 13 10 14 11 13 14 11 10 12 11 22 13 14 22 22 22 22 22 22 22 22 22 22 12 55 17 17 40 21 20 20
20 21 20 44 17 17 59 13 14 12 10 11 10 14 13 12 10 10 11 12 22 22 12 22 11 13 22 12 10 13 14 22 22 55 17 17 40 20 20 21
20 20 21 44 17 17 59 12 11 10 11 14 13 10 12 10 11 11 10 12 13 10 22 22 11 22 12 12 22 11 10 22 22 55 17 17 40 20 21 20
20 20 20 44 17 17 59 11 12 13 10 14 10 14 13 13 11 10 12 22 12 11 22 22 10 13 22 10 22 22 22 22 14 55 17 17 40 20 20 20
20 20 21 44 17 17 59 13 11 16 16 16 16 10 14 14 11 12 10 22 13 22 12 22 12 22 11 12 10 13 10 22 13 55 17 17 40 21 20 20
21 20 20 44 17 17 59 10 11 16 15 16 15 16 11 13 12 12 10 11 11 10 11 12 10 22 11 22 13 22 12 22 22 55 17 17 40 20 21 20
20 20 20 44 17 17 59 12 13 16 15 15 15 15 11 10 12 11 10 13 22 14 22 22 14 13 22 10 11 22 12 22 11 55 17 17 40 20 20 21
20 20 20 44 17 17 59 14 13 16 15 15 15 16 11 12 10 11 10 22 12 10 13 22 13 22 14 10 22 14 13 22 12 55 17 17 40 20 21 20
21 20 20 44 17 17 59 12 13 11 16 15 16 15 16 13 10 14 13 22 11 22 22 22 12 22 22 11 22 10 11 22 10 55 17 17 40 21 20 20
20 20 20 44 17 17 59 12 10 11 16 15 15 15 15 12 11 13 14 10 22 12 12 22 11 11 10 14 22 10 13 22 22 55 17 17 40 20 20 20
20 21 20 44 17 17 59 12 10 11 16 16 16 16 16 14 14 11 12 22 12 22 22 22 22 22 22 22 22 22 22 22 13 55 17 17 40 20 21 20
21 20 20 44 17 17 59 14 11 12 13 10 11 10 11 10 12 13 13 10 14 10 22 22 22 10 10 22 10 22 22 14 12 55 17 17 40 20 20 21
20 20 21 44 17 17 52 53 53 53 53 53 53 53 53 53 53 53 53 53 53 53 53 53 53 53 53 53 53 53 53 53 53 54 17 17 40 21 20 20
20 20 20 44 17 17 17 17 17 17 17 17 17 17 17 17 17 17 17 17 17 17 17 17 17 17 17 17 17 17 17 17 17 17 17 17 40 21 20 20
20 21 20 44 17 17 17 17 17 17 17 17 17 17 17 17 17 17 17 17 17 17 17 17 17 17 17 17 17 17 17 17 17 17 17 17 40 20 21 20
21 20 21 38 46 46 46 46 46 46 46 46 46 46 46 46 46 46 46 46 46 46 46 46 46 46 46 46 46 46 46 46 46 46 46 46 39 20 20 21
20 20 20 20 20 20 20 20 20 20 20 20 20 20 20 21 20 20 20 21 20 20 20 20 20 20 21 21 21 20 20 21 20 20 20 21 20 20 20 20
21 20 21 21 21 20 20 37 42 36 20 20 21 20 20 20 20 20 20 20 20 20 20 21 20 20 20 20 20 20 20 20 20 20 20 20 20 21 21 20
20 20 20 20 20 20 20 44 17 40 20 20 20 20 20 20 21 20 21 21 21 20 20 20 20 21 20 20 20 20 20 21 21 21 20 20 20 20 20 21
20 21 20 21 20 21 21 38 46 39 21 21 21 21 20 20 20 20 20 20 20 20 20 20 20 20 20 20 20 21 20 20 20 20 20 21 21 21 20 20
20 20 20 20 20 20 20 20 20 20 20 20 20 20 20 20 20 20 21 20 20 20 20 20 21 21 21 20 20 20 20 20 20 20 20 20 20 20 20 21

