20 20 20 20 20 20 20 20 20 20 20 20 20 20 20 20 20 20 20 20 20 20 20 20 20 20 20 20 20 20 20 20 20 20 20 20 20 20 20 20
20 20 20 20 20 20 20 20 20 20 20 20 20 20 20 20 20 20 20 20 20 20 20 20 20 20 20 20 20 20 20 20 20 20 20 20 20 20 20 20
20 20 25 29 29 29 29 29 29 29 29 29 29 29 29 29 29 29 29 29 29 29 29 29 29 29 29 29 29 29 29 29 29 29 29 29 29 24 20 20
20 20 31 10 10 15 10 10 10 10 10 10 10 10 10 10 10 10 10 10 10 10 10 10 10 10 10 10 10 10 10 10 10 10 10 10 10 35 20 20
20 20 31 10 16 15 15 16 16 16 10 10 10 10 10 10 10 10 10 10 10 10 10 10 22 10 10 16 10 10 10 10 10 10 10 10 10 35 20 20
20 20 31 10 16 15 15 16 15 16 10 10 10 10 10 10 10 10 10 10 10 10 10 10 16 16 16 16 10 10 10 10 22 10 10 10 10 35 20 20
20 20 31 16 16 15 15 15 15 16 10 10 10 10 10 10 10 10 10 10 10 10 10 15 15 15 15 16 16 10 10 10 10 22 10 22 10 35 20 20
20 20 31 10 16 15 15 15 16 16 16 10 10 10 10 10 10 10 10 10 10 10 10 10 15 15 15 15 16 10 10 10 10 10 10 10 10 35 20 20
20 20 31 10 16 16 15 15 15 16 16 10 10 10 10 10 10 10 10 10 10 10 10 16 15 15 15 15 16 10 10 10 10 22 10 10 22 35 20 20
20 20 31 10 16 15 15 16 15 16 10 10 10 10 10 10 10 10 10 10 10 10 16 16 15 15 15 16 16 16 10 10 10 10 22 10 10 35 20 20
20 20 31 10 16 15 16 15 15 16 16 10 10 10 10 10 10 10 10 10 10 10 10 16 15 15 16 16 16 10 10 10 10 10 10 10 10 35 20 20
20 20 31 16 16 15 15 15 15 16 10 16 10 10 10 10 10 10 10 10 10 10 16 16 15 15 16 10 22 22 10 10 22 10 10 10 22 35 20 20
20 20 31 10 16 16 16 16 16 16 10 10 10 10 10 10 10 10 10 10 10 16 10 16 16 16 16 16 10 10 22 10 10 10 10 10 10 35 20 20
20 20 31 10 16 10 16 16 16 10 16 10 10 10 10 10 10 10 10 10 10 10 10 22 16 10 22 10 10 10 10 10 10 22 10 10 10 35 20 20
20 20 31 10 10 10 10 10 16 10 10 10 10 10 10 10 10 10 10 10 10 10 10 10 10 22 10 10 10 22 10 10 10 10 10 10 22 35 20 20
20 20 31 10 10 10 10 10 10 10 10 10 10 10 10 10 10 10 10 10 10 10 10 10 10 10 10 10 22 10 22 10 10 10 10 22 10 35 20 20
20 20 31 10 10 10 10 10 10 10 10 10 10 10 10 10 10 10 10 10 10 10 10 10 22 10 10 10 10 22 34 33 33 33 32 10 22 35 20 20
20 20 31 10 10 10 10 10 10 10 10 10 10 10 10 10 10 10 10 10 10 10 10 10 10 10 10 22 10 10 35 20 25 24 31 10 10 35 20 20
20 20 31 10 10 10 10 10 10 10 10 10 10 10 10 10 10 10 10 10 10 10 10 10 10 10 10 10 10 22 35 20 26 27 31 10 22 35 20 20
20 20 31 10 10 10 10 10 10 10 10 10 10 10 10 10 10 10 10 10 10 10 10 10 22 22 10 22 10 10 28 29 29 29 30 10 10 35 20 20
20 20 31 10 10 10 10 10 10 10 10 10 10 10 10 10 10 10 10 10 10 10 10 10 10 10 10 10 10 10 10 10 10 10 22 10 10 35 20 20
20 20 31 10 10 10 10 10 10 10 10 10 10 10 10 10 10 10 10 10 10 10 10 10 10 10 10 10 22 10 10 10 10 10 10 22 10 35 20 20
20 20 31 10 10 10 10 10 10 10 10 10 10 10 10 10 10 10 10 10 10 10 10 10 22 10 22 10 10 10 10 10 10 10 10 10 10 35 20 20
20 20 31 10 10 10 10 10 10 10 10 10 10 10 10 10 10 10 10 10 10 22 10 10 10 10 10 22 10 22 10 10 10 10 22 22 10 35 20 20
20 20 31 10 10 10 10 10 10 10 10 10 10 10 10 10 10 10 10 10 10 10 10 22 10 22 10 10 10 10 22 10 22 10 10 10 22 35 37 36
20 20 31 10 10 10 10 10 10 10 10 10 10 10 10 10 10 10 10 10 10 22 10 10 10 10 22 10 10 10 22 10 10 10 22 10 10 35 38 39
20 20 31 10 10 10 10 10 10 10 10 10 10 10 10 10 10 10 10 10 22 10 22 10 10 10 10 22 10 22 10 10 22 10 10 10 22 28 29 24
20 20 31 10 10 10 10 10 10 10 10 10 10 10 10 10 10 10 10 10 10 10 10 10 22 22 10 22 10 22 10 22 22 10 10 22 10 22 10 28
20 20 31 10 10 10 10 10 10 10 10 10 10 10 10 10 10 10 10 10 10 22 10 10 10 10 10 10 10 10 10 10 10 22 10 10 10 10 10 10
20 20 31 49 53 53 53 53 53 48 10 10 10 10 10 10 10 10 10 10 10 10 22 10 22 10 10 22 22 22 22 10 10 22 10 22 22 10 22 22
20 20 31 54 17 17 17 17 17 59 10 10 10 10 10 10 10 10 10 10 10 10 10 10 22 10 22 10 22 10 10 22 10 10 10 10 10 22 22 22
20 20 44 17 17 17 17 17 17 59 10 10 10 10 10 10 10 10 10 10 10 22 22 22 10 10 10 10 10 22 22 10 10 22 10 22 10 10 22 22
20 20 44 17 17 17 17 17 17 59 10 10 10 10 10 10 10 10 10 10 10 10 10 10 22 10 10 22 10 10 22 22 10 22 10 10 10 10 22 22
20 20 44 17 17 17 17 17 17 59 10 10 10 10 10 10 10 10 10 10 22 10 10 22 10 10 22 10 10 22 10 10 10 10 22 10 10 22 22 22
20 20 44 17 17 17 17 17 17 59 10 10 10 10 10 10 10 10 10 10 10 10 10 22 10 22 10 22 10 10 10 10 22 10 10 22 10 10 22 22
20 20 44 17 17 17 17 17 17 52 48 10 10 10 10 10 10 10 10 10 22 10 10 10 10 10 22 10 10 22 10 22 10 22 22 10 10 22 22 22
20 20 44 17 17 17 17 17 17 17 52 10 10 10 10 10 10 10 10 10 10 22 10 22 10 22 10 22 22 10 10 10 10 10 10 10 10 22 22 22
20 20 38 46 46 46 46 46 46 46 46 33 33 33 33 33 33 33 33 33 33 33 33 33 33 32 10 10 22 10 22 22 10 22 22 10 10 10 22 22
20 20 20 20 20 20 20 20 20 20 20 20 20 20 20 20 20 20 20 20 20 20 20 20 20 31 10 22 22 22 22 22 22 22 22 22 22 22 22 22
20 20 20 20 20 20 20 20 20 20 20 20 20 20 20 20 20 20 20 20 20 20 20 20 20 31 22 22 22 22 22 22 22 22 22 22 22 22 22 22