14 14 14 14 14 14 14 14 14 14 14 14 14 14 14 14 14 14 14 14 14 14 14 14 14 14 14 14 14 14 14 14 14 14 14 14 14 14 14 14
14 14 14 14 14 14 14 14 14 14 14 14 14 14 14 14 14 14 14 14 14 14 14 14 14 14 14 14 14 14 14 14 14 14 14 14 14 14 14 14
14 14 14 14 14 14 14 14 14 14 14 14 14 14 14 14 14 14 14 14 14 14 14 14 14 14 14 14 14 14 14 14 14 14 14 14 14 14 14 14
14 14 14 14 14 14 16 14 14 16 14 14 14 16 16 14 14 16 14 16 16 14 16 16 14 16 16 14 16 16 16 16 14 14 16 14 14 14 14 14
14 14 14 14 14 16 16 16 16 16 16 16 16 16 16 16 16 16 16 16 16 16 16 16 16 16 16 16 16 16 16 16 16 16 16 16 16 14 14 14
14 14 14 14 16 16 18 16 16 17 16 18 16 18 17 16 16 16 16 16 10 10 16 16 15 15 16 16 15 16 15 16 16 16 16 16 16 14 14 14
14 14 14 14 16 16 16 22 16 16 17 16 16 17 16 16 10 11 10 12 15 10 15 15 15 15 15 15 15 15 15 15 15 16 16 16 14 14 14 14
14 14 14 16 16 17 16 16 14 22 16 18 17 16 16 11 10 11 10 10 12 15 11 15 15 15 15 15 15 15 15 15 10 11 16 16 16 14 14 14
14 14 14 14 16 16 16 18 14 14 22 16 16 16 16 16 11 10 11 11 10 15 10 15 15 15 15 15 15 15 15 15 10 15 10 16 16 14 14 14
14 14 14 14 16 17 16 16 22 14 16 16 18 16 18 16 11 11 11 10 15 10 15 15 15 15 15 15 15 15 15 15 15 10 10 16 14 14 14 14
14 14 14 16 16 16 17 16 16 16 16 16 17 16 16 10 10 12 10 12 12 15 10 15 10 15 15 10 15 10 15 15 10 15 16 16 14 14 14 14
14 14 14 14 16 16 18 17 16 17 16 16 16 18 16 16 10 10 12 10 11 21 15 21 10 10 15 21 10 21 15 21 12 21 10 16 16 14 14 14
14 14 14 16 16 16 16 12 16 16 12 16 16 10 16 12 11 10 10 11 21 10 21 21 21 21 21 21 21 21 21 21 21 12 10 16 14 14 14 14
14 14 14 14 16 16 11 12 10 10 12 10 10 11 10 10 10 12 10 11 21 21 21 10 21 11 10 10 21 11 21 21 21 21 11 16 14 14 14 14
14 14 14 16 16 11 10 11 10 11 10 12 10 11 10 10 10 10 11 21 11 10 21 10 10 10 21 11 21 10 12 10 21 10 11 16 16 14 14 14
14 14 14 14 16 10 11 10 12 10 12 10 11 12 10 12 10 10 12 10 12 21 21 12 21 10 21 10 10 12 21 11 21 10 16 16 16 14 14 14
14 14 14 16 16 16 12 10 10 10 11 11 10 10 11 10 11 10 10 21 10 10 21 12 21 10 10 12 21 10 21 10 21 21 10 16 14 14 14 14
14 14 14 14 16 10 10 11 10 12 10 10 11 11 10 12 10 12 10 11 21 21 21 10 21 12 21 10 10 21 21 12 21 10 16 16 16 14 14 14
14 14 14 16 16 16 12 10 11 10 12 10 11 10 12 10 10 11 10 10 10 11 10 10 21 10 21 12 11 21 21 11 21 12 16 16 16 14 14 14
14 14 14 14 16 16 12 10 10 12 10 12 10 10 10 10 12 10 11 10 21 21 10 10 21 21 10 21 12 21 10 11 21 21 10 16 14 14 14 14
14 14 14 16 16 16 10 11 11 10 10 10 10 12 11 10 10 10 10 21 10 21 21 12 10 12 21 10 21 21 12 10 21 10 11 16 14 14 14 14
14 14 14 14 16 12 11 10 10 13 13 10 12 10 11 12 10 12 10 12 21 10 21 11 21 10 12 11 21 21 21 21 21 10 10 16 16 14 14 14
14 14 14 16 16 10 10 10 13 12 10 12 13 12 10 10 11 10 10 21 10 21 21 10 21 21 21 10 21 11 12 10 21 21 16 16 16 14 14 14
14 14 14 14 16 16 10 12 13 13 13 13 13 13 13 10 11 10 12 10 21 11 21 11 10 12 21 21 21 10 21 10 21 12 16 16 16 14 14 14
14 14 14 14 16 10 10 10 13 11 13 10 12 13 13 12 10 11 10 21 12 21 21 10 21 21 21 12 21 10 21 12 21 10 16 16 14 14 14 14
14 14 14 14 16 16 11 10 13 12 11 12 10 13 13 13 12 10 12 10 11 10 21 11 10 10 10 11 10 10 11 21 21 21 11 16 14 14 14 14
14 14 14 16 16 16 10 10 13 13 10 13 13 11 10 11 10 10 10 21 10 21 21 21 21 21 21 21 21 21 21 21 21 12 16 16 14 14 14 14
14 14 14 14 16 11 10 11 13 10 10 10 11 13 13 12 12 10 12 21 10 10 21 10 11 21 10 21 21 12 21 21 10 21 16 16 16 14 14 14
14 14 14 14 16 16 10 13 10 13 13 11 10 11 10 10 10 11 10 11 11 21 11 12 21 11 10 11 10 21 11 21 12 10 10 16 16 14 14 14
14 14 14 16 16 16 12 13 13 12 13 10 13 11 13 13 13 13 10 10 10 12 10 10 12 10 11 10 12 10 10 10 11 11 10 16 14 14 14 14
14 14 14 16 16 11 10 10 13 10 12 10 13 12 13 13 10 13 11 10 10 10 15 12 10 11 10 10 15 15 12 12 11 10 16 16 16 14 14 14
14 14 14 14 16 16 16 13 13 13 13 13 13 13 13 13 10 13 10 11 10 10 10 10 15 12 11 15 10 11 10 10 10 10 12 16 16 14 14 14
14 14 14 16 16 16 16 16 13 16 11 13 13 16 16 13 16 16 16 10 12 16 10 16 10 16 16 16 12 16 12 16 11 16 16 16 16 14 14 14
14 14 14 16 19 16 16 16 16 16 16 13 16 16 16 16 16 16 16 16 16 16 16 16 16 16 16 16 16 16 16 16 19 19 16 16 14 14 14 14
14 14 14 19 19 14 16 14 16 14 14 16 14 14 16 14 16 16 14 16 16 14 16 14 14 16 16 14 14 14 16 14 19 19 14 16 14 14 14 14
14 14 14 19 19 14 14 14 14 14 14 14 14 14 14 14 14 14 14 14 14 14 14 14 14 14 14 14 14 14 14 14 19 19 14 14 14 14 14 14
14 14 14 19 19 20 20 20 20 20 20 20 20 20 20 20 20 20 20 20 20 20 20 20 20 20 20 20 20 20 20 20 19 19 14 14 14 14 14 14
14 14 14 19 19 20 20 20 20 20 20 20 20 20 20 20 20 20 20 20 20 20 20 20 20 20 20 20 20 20 20 20 19 19 14 14 14 14 14 14
14 14 14 14 14 14 14 14 14 14 14 14 14 14 14 14 14 14 14 14 14 14 14 14 14 14 14 14 14 14 14 14 14 14 14 14 14 14 14 14
14 14 14 14 14 14 14 14 14 14 14 14 14 14 14 14 14 14 14 14 14 14 14 14 14 14 14 14 14 14 14 14 14 14 14 14 14 14 14 14