6 6 6 6 6 6 6 6 6 6 6 6 6 6 6 8 6 6 6 6 6 6 6 6 0 1 0 2 0 0 0 1 2 0 0 2 0 0 0 5 5 5 5 5 5 5 5 5 5 5 
6 7 6 6 6 8 6 6 8 6 6 6 6 6 6 6 6 6 6 7 6 6 6 0 0 0 0 0 0 2 0 0 0 0 1 0 0 0 0 0 5 5 5 5 5 5 5 5 5 5 
6 6 6 6 6 6 6 6 6 6 7 6 6 6 6 6 6 6 8 6 6 6 0 6 2 0 0 0 1 0 0 1 0 0 0 0 0 0 5 5 0 5 0 5 5 0 0 5 0 5
6 8 6 6 6 6 6 6 6 6 6 7 6 6 6 6 6 6 6 6 6 6 6 0 0 1 0 2 0 0 1 0 0 0 0 0 0 2 0 0 0 0 0 0 0 5 0 0 0 0 
7 6 6 6 12 6 6 6 6 6 6 6 6 6 6 8 6 6 6 6 6 6 0 6 0 0 0 0 0 0 0 1 0 0 0 1 0 0 0 1 0 0 1 0 2 0 0 1 0 0 
6 6 6 4 4 6 6 7 6 6 6 6 8 6 6 6 6 6 7 6 6 6 0 0 0 2 0 0 1 0 0 0 2 0 0 0 0 0 0 4 0 0 2 2 0 0 2 0 0 0 
7 6 6 12 4 6 6 6 6 6 6 6 6 8 6 6 6 6 6 6 6 6 6 6 2 0 2 0 0 0 0 4 4 4 4 0 4 0 4 4 0 4 4 1 0 2 0 0 1 0 
6 8 6 6 12 6 6 6 6 6 6 6 6 6 6 6 6 6 6 6 6 6 6 0 0 0 0 0 2 0 0 4 4 4 4 4 4 4 4 4 4 4 4 0 2 0 2 0 0 0 
6 6 6 6 6 6 6 6 6 6 6 6 6 8 6 7 6 6 6 6 6 6 6 1 0 0 0 0 1 0 0 4 4 4 4 4 4 4 4 4 4 4 4 4 0 1 0 1 0 0 
6 6 7 6 6 6 6 6 6 6 7 6 6 6 6 7 6 6 6 6 6 6 2 0 0 2 0 0 0 2 0 0 4 4 4 4 4 4 4 4 4 4 4 0 4 0 2 0 2 0 
6 8 6 6 6 6 6 6 6 6 6 6 6 6 6 6 6 6 6 8 6 6 6 2 2 0 1 0 1 0 0 0 4 4 4 4 4 4 4 1 4 4 4 4 4 0 0 0 0 2 
6 6 6 7 6 6 6 7 6 6 6 6 6 6 6 6 8 6 6 6 6 6 0 0 0 2 0 0 0 1 0 4 4 4 4 4 4 4 0 2 4 4 4 4 0 2 0 0 1 0 
6 6 6 6 8 6 6 6 6 6 6 6 6 6 6 6 6 6 6 6 6 6 6 2 0 0 2 0 2 0 0 0 4 4 4 4 4 4 4 4 4 4 4 0 1 0 0 2 0 0 
6 6 6 6 6 6 6 6 6 7 6 6 8 6 6 6 6 6 6 6 6 6 0 6 0 1 0 1 2 0 0 4 4 4 4 4 4 4 4 4 4 4 4 4 0 0 1 0 0 0 
7 6 6 6 6 6 6 6 6 6 6 6 6 6 6 6 6 7 6 6 6 6 0 0 2 0 0 0 0 0 1 0 4 0 4 4 0 4 4 0 0 4 0 2 0 0 0 0 1 0 
6 6 8 6 6 6 6 6 6 6 6 6 6 6 8 6 6 6 6 6 6 6 6 0 0 0 1 0 0 1 0 2 0 0 0 4 0 0 0 1 0 0 0 0 1 0 0 2 0 1 
6 6 6 6 8 6 6 6 6 8 6 6 6 6 6 6 6 8 6 6 6 6 0 6 0 2 0 0 1 0 2 0 0 1 0 1 0 0 2 0 0 0 1 0 0 0 2 0 1 0 
3 3 6 6 0 0 6 0 2 0 6 0 2 0 0 6 0 0 6 0 0 6 6 2 0 0 0 2 0 0 0 1 0 0 2 0 1 1 0 1 0 1 0 0 0 0 0 2 0 1 
3 0 3 1 0 0 6 6 0 1 0 1 6 0 2 0 6 0 0 1 6 0 1 0 0 1 1 0 0 0 0 0 2 0 0 2 2 0 0 11 0 2 0 11 0 0 11 0 2 11 
3 1 3 0 3 3 0 0 0 1 0 5 0 1 0 0 0 2 0 2 2 0 0 0 2 0 0 2 0 0 0 11 0 0 0 11 0 11 11 0 2 11 0 0 11 1 0 0 1 0 
3 0 0 0 0 3 1 2 0 0 2 0 2 0 2 2 0 1 0 0 0 0 2 0 0 0 11 0 11 11 0 2 0 11 0 2 11 0 11 0 11 0 0 11 0 0 11 0 11 0 
3 0 3 3 0 0 3 0 2 5 0 5 5 0 0 0 0 1 0 2 2 0 0 0 0 11 0 0 0 11 0 11 1 11 0 11 0 11 0 0 0 11 0 11 2 11 0 2 11 0 
3 2 3 0 1 0 3 1 0 0 2 0 1 0 5 1 0 0 2 1 0 1 0 0 11 0 11 0 11 2 2 0 0 0 11 2 0 11 0 11 1 0 1 0 2 0 0 11 0 0 
3 0 1 0 0 0 3 0 0 5 2 5 0 0 5 0 2 0 0 0 1 0 2 0 0 2 0 1 0 0 1 0 1 11 1 11 0 11 0 0 0 11 2 0 11 0 11 11 2 11
3 2 0 3 3 2 3 2 0 0 5 0 0 5 0 2 0 1 1 0 0 2 0 11 0 11 0 0 11 0 11 1 11 11 11 11 11 11 11 11 11 11 11 11 11 11 11 11 11 11 
3 3 0 3 1 0 3 0 1 0 0 2 0 0 0 2 0 1 0 2 2 0 2 0 11 1 11 2 0 0 1 11 11 1 11 2 0 2 11 0 1 0 1 0 11 0 0 0 0 11 
3 0 1 0 0 3 3 0 0 0 1 0 0 0 2 0 1 0 2 0 0 11 0 2 0 0 2 0 11 2 0 11 11 1 0 2 11 0 1 0 11 11 11 2 11 0 11 1 0 11 
3 3 3 3 3 0 1 0 0 2 0 0 0 1 0 2 0 2 0 1 0 0 0 11 2 11 0 11 0 0 0 11 0 11 11 11 11 11 2 0 0 11 0 0 1 0 2 1 0 11 
3 0 2 1 0 3 0 2 0 0 0 1 0 0 1 0 2 0 1 0 0 0 11 0 0 1 0 0 11 0 2 0 2 0 11 0 0 0 0 0 11 0 1 0 11 11 11 11 0 11 
3 3 3 2 0 3 0 0 2 0 2 1 0 0 0 0 0 1 0 1 0 2 0 11 1 11 1 1 0 11 1 0 11 0 11 0 11 11 11 0 1 0 11 11 11 0 1 0 2 11 
3 0 0 0 3 3 2 0 0 0 0 0 0 2 0 2 1 0 0 0 0 2 0 11 11 0 0 0 11 1 0 0 11 1 11 0 11 0 11 0 11 0 11 0 0 2 0 0 2 11 
3 2 0 2 1 3 0 1 0 2 0 4 4 0 1 0 0 0 2 0 1 0 11 0 0 11 0 2 11 2 0 2 11 0 11 0 11 0 11 0 11 2 0 0 11 11 0 11 0 11 
3 0 1 3 3 3 0 0 1 2 0 4 4 4 0 0 0 2 0 1 0 1 2 0 1 0 0 11 0 1 2 11 11 0 0 0 11 0 11 0 11 0 11 1 0 11 11 11 0 11 
3 2 0 1 0 3 1 0 0 0 0 4 1 0 2 0 2 0 2 0 0 11 0 0 11 0 0 0 2 0 11 11 11 0 11 0 11 0 0 0 1 0 11 11 1 11 1 11 0 11 
3 0 2 3 3 3 0 0 0 2 1 2 0 0 0 0 1 0 0 0 2 0 11 2 0 0 11 2 0 0 0 0 11 0 11 0 0 0 11 0 11 2 0 11 0 11 2 2 0 11 
3 2 0 3 2 3 0 1 0 0 1 0 2 0 0 1 0 2 2 2 0 2 0 11 11 11 0 1 0 11 0 0 11 0 11 0 11 0 0 2 0 11 11 11 0 11 1 0 2 11 
3 0 0 1 0 3 0 0 0 2 0 0 1 0 2 2 0 2 0 0 0 0 1 0 0 2 0 11 0 1 0 11 11 1 0 11 2 11 1 11 0 1 0 1 0 11 2 0 1 11 
3 3 0 3 3 3 0 1 0 0 1 0 0 2 0 0 2 0 2 0 2 0 11 0 11 11 0 1 0 11 0 0 11 11 11 11 11 11 11 11 11 11 11 11 11 11 11 11 11 11 
0 0 2 0 2 0 1 0 0 2 0 2 0 0 0 1 0 0 0 2 0 0 0 11 2 0 11 2 0 0 1 11 0 2 0 11 1 0 11 0 1 11 2 11 0 11 11 1 11 11
0 1 0 2 0 1 0 0 2 0 1 0 0 2 0 2 0 0 1 0 0 2 0 0 0 1 0 0 0 11 0 2 0 11 1 0 2 0 11 1 0 0 11 2 0 11 2 0 11 2 
6 6 0 6 0 0 6 6 0 6 6 6 0 0 6 0 0 2 6 0 2 0 6 6 0 6 0 6 6 6 0 6 6 0 6 0 0 0 6 0 0 0 6 0 0 0 0 6 0 0 
6 6 6 6 6 6 6 6 6 6 6 6 6 6 6 6 6 6 6 6 6 6 6 6 6 6 6 6 6 6 6 6 6 6 6 6 6 6 6 6 6 6 6 6 6 6 6 6 6 6  
6 9 9 6 6 6 6 6 6 6 6 6 6 6 6 6 6 6 6 6 6 6 6 6 6 6 6 6 6 6 6 6 6 6 6 6 6 6 6 6 6 6 6 6 6 9 9 6 6 6 
4 9 9 4 4 4 4 4 4 4 4 4 4 4 4 4 4 4 4 4 4 4 4 4 4 4 4 4 4 4 4 4 4 4 4 4 4 4 4 4 4 4 4 4 4 9 9 4 4 4  
4 9 9 10 10 10 10 10 10 10 10 10 10 10 10 10 10 10 10 10 10 10 10 10 10 10 10 10 10 10 10 10 10 10 10 10 10 10 10 10 10 10 10 10 10 9 9 4 4 4 
4 9 9 10 10 10 10 10 10 10 10 10 10 10 10 10 10 10 10 10 10 10 10 10 10 10 10 10 10 10 10 10 10 10 10 10 10 10 10 10 10 10 10 10 10 9 9 4 4 4 
4 4 4 4 4 4 4 4 4 4 4 4 4 4 4 4 4 4 4 4 4 4 4 4 4 4 4 4 4 4 4 4 4 4 4 4 4 4 4 4 4 4 4 4 4 4 4 4 4 4 
4 4 4 4 4 4 4 4 4 4 4 4 4 4 4 4 4 4 4 4 4 4 4 4 4 4 4 4 4 4 4 4 4 4 4 4 4 4 4 4 4 4 4 4 4 4 4 4 4 4 
4 4 4 4 4 4 4 4 4 4 4 4 4 4 4 4 4 4 4 4 4 4 4 4 4 4 4 4 4 4 4 4 4 4 4 4 4 4 4 4 4 4 4 4 4 4 4 4 4 4 
4 4 4 4 4 4 4 4 4 4 4 4 4 4 4 4 4 4 4 4 4 4 4 4 4 4 4 4 4 4 4 4 4 4 4 4 4 4 4 4 4 4 4 4 4 4 4 4 4 4 